1111111111111
10C00000C0001
1000000000001
1P0000E00C001
1111111111111
