1111111111111
10C00000C0001
1000P00000001
100000E00C001
1111111111111
