1111111111111
10C0000000001
1000000000001
10000PE0P0001
1111111111111
